EEEWEEEEE
EEWDWWEEE
EEEEEEEEE
EEEWEEEEE
EEEWEEEEE
EEEWEEEAE
EEEWEEEEE
EEEWEEEEE